NO textures/wall_1.xpm
SO textures/wall_2.xpm
WE textures/wall_3.xpm
EA textures/wall_4.xpm
C 51,198,227
F 184,113,39

11111111111111111111111111111
11111111111111111111111111111        111
10000000001100000000000000001        11
10110000011100000000000010001
10010000000000000000000010001
10110000011100000000000010001
10000000001100000111011110001
11110111111111011100000010001
11110111111111011101010010011
11111111111111111111111111111

11111111111111111111111111111
11000000110101011100000010011
1000000000000000110000001001
10000000000000001100010000011
11000000110101000000000000001
11111111110101000000000000001
10000000001100000100000010001
10000000000000000000000001001
10000000001000010000N00001001
10000000001101000000000000001
10000000000100000001010000001
11111111111111111111111111111
