NO textures/Pac-Man/Ghosts/Panic/ghost_panic1a.xpm
NO textures/Pac-Man/Ghosts/Panic/ghost_panic1b.xpm
NO textures/Pac-Man/Ghosts/Panic/ghost_panic2a.xpm
NO textures/Pac-Man/Ghosts/Panic/ghost_panic2b.xpm
SO textures/Pac-Man/pac_open_right.xpm
SO textures/Pac-Man/pac_semi_right.xpm
SO textures/Pac-Man/pac_closed.xpm
SO textures/Pac-Man/pac_semi_right.xpm
EA textures/Pac-Man/Dying/pacman_dying1.xpm
EA textures/Pac-Man/Dying/pacman_dying2.xpm
EA textures/Pac-Man/Dying/pacman_dying3.xpm
EA textures/Pac-Man/Dying/pacman_dying4.xpm
EA textures/Pac-Man/Dying/pacman_dying5.xpm
EA textures/Pac-Man/Dying/pacman_dying6.xpm
EA textures/Pac-Man/Dying/pacman_dying7.xpm
EA textures/Pac-Man/Dying/pacman_dying8.xpm
EA textures/Pac-Man/Dying/pacman_dying9.xpm
EA textures/Pac-Man/Dying/pacman_dying10.xpm
EA textures/black.xpm
EA textures/Pac-Man/Dying/pacman_woosh.xpm
EA textures/black.xpm
EA textures/black.xpm
EA textures/Pac-Man/Dying/pacman_woosh.xpm
EA textures/black.xpm
WE textures/Pac-Man/pac_open_left.xpm
WE textures/Pac-Man/pac_semi_left.xpm
WE textures/Pac-Man/pac_closed.xpm
WE textures/Pac-Man/pac_semi_left.xpm


F 0,0,0
C 0,0,0

111111111111111111111111111111
100000000000000000000000000001
101111111111110000000011100001
100000000000000000110000000001
100000000000000000110000000001
100000000001000000000100000001
101111110001110110000100100001
100000000000000000000111110001
101111110000100N00000100000001
101000010000100000000000000001
101000010000100111111110000001
101000010000100000000010000001
101000010000100111111110000001
100000000000100000000000000001
100000110000100110000110000001
100000110000100000000000000001
100000000000100000000000000001
111111111111111111111111111001
101010101010111111111111111111
111111111111111111111111111111
