NO textures/wall_1.xpm
SO textures/wall_2.xpm
WE textures/wall_3.xpm
EA textures//wall_4.xpm
C 51,198,227
F 184,113,39

             11111111111111111111111111111
11111111111111111111111111111        11111
10000000001100000000000000001        10101
10110000011100000000000010001        11111
100100000000000000W0000010001
10110000011100000000000010001
10000000001100000111011110001
1111111111111111111111111111111      111111
1111011111111101110000001000111      111 11
11110111111111011101010010011        111111
11111111000000000001111111111
10000000000000000000000000001
11000000110101011100000010011
1000000000000000110000001001
10000000000000001100010000011
11000000110101000000000000001
11111111110101000000000000001
10000000001100000100000010001
10000000000000000000000001001
10000000001000010000000001001
10000000001101000000000000001
10000000000100000001010000001
11111111111111111111111111111
